{
  "reporter_code": "699",
  "reporter_name": "India",
  "years": [
    2009,
    2010
  ],
  "classification": "HS",
  "frequency": "A",
  "flows": [
    "import",
    "export"
  ],
  "partner_code": "all",
  "max_codes_per_batch": 20,
  "commodity_codes": [
    "010110",
    "010111",
    "010119",
    "010120",
    "010121",
    "010129",
    "010130",
    "010190",
    "010210",
    "010221",
    "010229",
    "010231",
    "010239",
    "010290",
    "010310",
    "010391",
    "010392",
    "010410",
    "010420",
    "010511",
    "010512",
    "010513",
    "010514",
    "010515",
    "010519",
    "010591",
    "010592",
    "010593",
    "010594",
    "010599",
    "010600",
    "010611",
    "010612",
    "010613",
    "010614",
    "010619",
    "010620",
    "010631",
    "010632",
    "010633",
    "010639",
    "010641",
    "010649",
    "010690",
    "020110",
    "020120",
    "020130",
    "020210",
    "020220",
    "020230",
    "020311",
    "020312",
    "020319",
    "020321",
    "020322",
    "020329",
    "020410",
    "020421",
    "020422",
    "020423",
    "020430",
    "020441",
    "020442",
    "020443",
    "020450",
    "020500",
    "020610",
    "020621",
    "020622",
    "020629",
    "020630",
    "020641",
    "020649",
    "020680",
    "020690",
    "020710",
    "020711",
    "020712",
    "020713",
    "020714",
    "020721",
    "020722",
    "020723",
    "020724",
    "020725",
    "020726",
    "020727",
    "020731",
    "020732",
    "020733",
    "020734",
    "020735",
    "020736",
    "020739",
    "020741",
    "020742",
    "020743",
    "020744",
    "020745",
    "020750",
    "020751",
    "020752",
    "020753",
    "020754",
    "020755",
    "020760",
    "020810",
    "020820",
    "020830",
    "020840",
    "020850",
    "020860",
    "020890",
    "020900",
    "020910",
    "020990",
    "021011",
    "021012",
    "021019",
    "021020",
    "021090",
    "021091",
    "021092",
    "021093",
    "021099",
    "030110",
    "030111",
    "030119",
    "030191",
    "030192",
    "030193",
    "030194",
    "030195",
    "030199",
    "030211",
    "030212",
    "030213",
    "030214",
    "030219",
    "030221",
    "030222",
    "030223",
    "030224",
    "030229",
    "030231",
    "030232",
    "030233",
    "030234",
    "030235",
    "030236",
    "030239",
    "030240",
    "030241",
    "030242",
    "030243",
    "030244",
    "030245",
    "030246",
    "030247",
    "030249",
    "030250",
    "030251",
    "030252",
    "030253",
    "030254",
    "030255",
    "030256",
    "030259",
    "030261",
    "030262",
    "030263",
    "030264",
    "030265",
    "030266",
    "030267",
    "030268",
    "030269",
    "030270",
    "030271",
    "030272",
    "030273",
    "030274",
    "030279",
    "030281",
    "030282",
    "030283",
    "030284",
    "030285",
    "030289",
    "030290",
    "030291",
    "030292",
    "030299",
    "030310",
    "030311",
    "030312",
    "030313",
    "030314",
    "030319",
    "030321"
  ]
}
